enzy	Lab
dsyn	Disease_disorder
qnco	Quantitative_concept
horm	Lab
elii	Lab
sosy	Sign_symptom
gngm	Lab
neop	Disease_disorder
emod	Disease_disorder
bacs	Lab
aapp	Lab
opco	Lab
irda	Lab
vita	Lab
chem	Lab
imft	Lab
bsoj	Anatomical_structure
antb	Lab
phsu	Lab
acty	Activity
bhvr	Activity
nnon	Lab
socb	Activity
ocac	Activity
qlco	Qualitative_concept
chvs	Lab
mcha	Activity
acab	Disease_disorder
menp	Lab
bdsu	Anatomical_structure
cell	Anatomical_structure
phsf	Lab
fndg	Disease_disorder
inch	Lab
inpo	Disease_disorder
evnt	Activity
chvf	Lab
nsba	Lab
celc	Anatomical_structure
ffas	Anatomical_structure
clnd	Medication
orch	Lab
clna	Lab
cgab	Disease_disorder
anst	Anatomical_structure
bdsy	Anatomical_structure
diap	Diagnostic_procedure
lipd	Lab
gora	Activity
dora	Activity
amas	Lab
patf	Disease_disorder
carb	Lab
ortf	Lab
comd	Disease_disorder
blor	Anatomical_structure
bpoc	Anatomical_structure
celf	Lab
rcpt	Lab
genf	Lab
moft	Lab
orga	Lab
orgf	Lab
crbs	Lab
mobd	Disease_disorder
emst	Anatomical_structure
lbpr	Diagnostic_procedure
hops	Lab
anab	Disease_disorder
tisu	Anatomical_structure
inbe	Activity
nusq	Lab
eico	Lab
bodm	Lab
mosq	Lab
strd	Lab
